IWIP	PT.INDONESIA WEDA BAY INDUSTRIAL PARK
LIPE	PT.LIPE METAL INDUSTRY
PMI	PT.PERKASA METAL INDUSTRY
WBP	PT.WEDA BAY PORT
PBI	PT.PLENTY BUMI INTERNATIONAL
LAN	PT.LANGIT METAL INDUSTRY
AMI	PT.ANDALAN METAL INDUSTRY
WBN	PT.WEDA BAY NICKEL
YII	PT.YASHI INDONESIA INVESTMENT
YNI	PT.YOUSHAN NICKEL INDONESIA
WSS	PT WEDA SEMESTA SEKURITI
HKNI	PT.HUAKE NICKEL INDONESIA
JLMI	PT.Jiu Long Metal Industry
IFMI	PT.Infei Metal Industry
MKUI	PT.Maluku Utara Metal Industry
ANI	PT.Angel Nickel Industry
GTHN	PT.Guang Tsing Halmahera Nickel
HFNC	PT.HUAFEI NICKEL COBALT
LVMI	PT. LIN VICTOR METAL INDUSTRY
KRS	PT.Kao Rahai Smelters
SNMI	PT.Sunny Metal Industry
RIM	PT.Ruby International Mining
DBNI	PT.Debonair Nickel Indonesia
LEE	PT.Lasting East Energy
SYMI	PT.Sky Brightness Metal Industry
WMI	PT.Westrong Metal Industry
MKMI	PT.Maluku Utara Mineral Industry
USMI	PT.Universe Smelter Metal Industry
JBMI	PT.Jade Bay Metal Industry
NEY	PT.CNGR Xingqiu New Energy
CMNI	PT.ChengMach Nicel Indonesia
JMNE	PT. JIAMAN NEW ENERGY
HSNI	PT.HUASHENG NICKEL INDONESIA
NMI	PT.NICOLE METAL INDUSTRY
PMKI	PT.PERINTIS MAKMUR INDONESIA
LTL	PT.LANDASAN TEKNIK LESTARI
UMT	PT.UNIVERSAL METAL TRADING
SIWM	PT.Super Indoweda Market
GNC	PT.Gourmet Nusantara Catering
TLH	PT.Trans Layanan Halmahera
TUJ	PT.Tanjung Ulie Jaya
LPI	PT.LAYANAN PEMELIHARAAN INTEGRASI
PII	PT.PELITA INDUSTRI INDONESIA
MOI	PT.MAKMUR OKSIGEN INDONESIA
MBP	PT.Maluku Banguntama Propertindo
IGI	PT.IWIP GREEN INDUSTRY
SIM	PT.SAPPHIRE INDONESIA MINING
LCMI	PT.LANCON METAL INDUSTRY
CMI	PT.COSAN METAL INDUSTRY
BSE	PT.BLUE SPARKING ENERGY
REI	PT. RARLON ENERGI INVESTASI
HXRI	PT.Huaxiang Refining Indonesia
ENI	PT.Eternal Nickel Industry
JYMI	PT.Jaya Metal Industry
WHMI	PT.Walhsu Metal Industry
DAI	PT.DAMAI AIR INDONESIA
	PT.CNGR Xingxin New Energy
	PT.CNGR Xingquan New Energy
WWP	PT.Wedabay Wind Power
HNNM	PT.HUANENG NEW MATERIAL
SRM	PT.SINAR RENTALINDO MOBIL
RBI	PT.REPT BATTERO INDONESIA
KAI	PT.Kemajuan Aluminium Industry
PAI	PT.Pioneer Aluminium Industries
GCNC	PT.Guang Ching Nickel Cobalt
BMSI	PT.BUMI SEMEN INDUSTRY
QAMI	PT.Qingtuo Automotive Manufacturing Indonesia
HSNC	PT.HUA SHAN NICKEL COBALT
FCEP	PT.FENGCHEN ENVIRONMENTAL PROTECTION TECHNOLOGY INDONESIA

